petrol - [noun]: бензин, нефть, горючее;
compete - [verb]: конкурировать; [adjective]: конкурентный
so_far - [adverb]: до сих пор;
up_until_now - [phrase]: до этого момента;
claim - [verb]: требовать, утверждать; [noun]: запрос, иск, требование;
overcome - [verb]: преодолеть, побороть, побеждать;
although - [conj]: хотя, несмотря на то что; [adverb]: несмотря на, если бы даже;
exciting - [adjective]: захватывающий, возбуждающий;
involve  - [verb]: включать, вовлекать;
fascinate - [verb]: очаровывать, пленять;
doubt - [verb]: сомневаться, колебаться; [noun]: сомнение;
daunt - [verb]: обескураживать, запугивать;
petrify - [verb]: окаменевать, остолбенеть;
plummet - [verb]: стремительно падать;
apart from - [adverb]: кроме, помимо, не считая;
itchy - [adjective]: зудящий;
slimy - [adjective]: слизистый, скользкий;
leech - [noun]: пиявка, кровопийца;
coward - [noun]: трус;
embark - [verb]: начинать, вступить в дело, грузиться на корабль;
delve - [verb]: копаться, рыться; [noun]: впадина;
on_their_own - [adverb]: самостоятельно;
unruly - [adjective]: непокорный, непослушный;
clumsy - [adjective]: неловкий, неуклюжий;
recall - [noun]: отзыв, воспоминание; [verb]: вспоминать, напоминать;
venture - [noun]: авантюра, предприятие; [verb]: отважиться, осмелиться;
embrace - [noun]: объятие; [verb]: обнимать, обхватывать;
obsess - [verb]: преследовать, овладеть;
repast - [noun]: трапеза, пиршество;
murky - [adjective]: темный, мрачный;
bowl - [none]: чашка, миска;
hurry - [verb]: торопиться; [noun]: спешка, поспешность;
maze - [noun]: лабиринт;
beyond - [proposal]: за, за пределами;
rumor - [noun]: слух;
presence - [noun]: присутствие, наличие;
depict - [verb]: изображать, описывать;
fearsome - [adjective]: грозный, страшный;
hike - [noun] - поход, подъем; [verb]: путешествовать;
comprise - [verb]: включать, содержать;
spite - [noun]: злость, злоба;
reveal - [verb]: выявить, раскрывать;
embelish - [verb]: приукрашивать;
resemble - [verb]: походить на, иметь сходство;
possess - [verb]: обладать, владеть;
enhance - [verb]: усиливать;
amplification - [noun]: усиление;
addict - [adjective]: склонный;
intend - [verb]: предназначать;
freebies - [noun]: халява;
essentially - [adverb]: по существу;
essential - [adjective]: существенный, необходимый;
commodity - [noun]: товар, продукт;
grip - [verb]: захватывать;
gory - [adjective]: окровавленный;
hysterical - [adjective]: истеричный;
creepy - [adjective]: жуткий;
suspense - [noun]: неизвестность, ожидание;
outstanding - [adjective]: выдающийся;
peerless - [adjective]: бесподобный, несравненный;
unlikely - [adverb]: навряд ли, едва ли; [adjective]: маловероятный, невероятный;
rival - [verb]: соперничать; [noun]: соперник;
masterpiece - [noun]: шедевр;
madcap - [noun]: сумасброд;
vast - [adjective]: огромный;
staggering - [adjective]: ошеломляющий;
proclaim - [noun]: провозглашать, объявлять;
get_out - [verb]: убирайся, выходить;
broad - [adjective]: широкий;
opulent - [adjective]: пышный;
plenty_more_besides - [phrase]: многое другое;
scruffy - [adjective]: неряшлевый, грязный;
keen - [adjective]: острый;
swirl - [noun]: водоворот, завихрение;
enriched - [adjective]: обогащенный;
lean - [verb]: опираться, наклоняться;
regardless - [adverb]: несмотря на;
stem - [verb]: происходить, брать начало;
ingrained - [adjective]: укоренившийся;
obstacle - [noun]: препятствие;
convenient - [adjective]: удобный, подходящий;
innocuous - [adjective]: безвредный, безобидный;
tear_up - [verb]: разорвать;
suspicion - [noun]: подозрение;
converge - [verb]: сходиться;
convience - [verb]: убеждать;
wondor - [verb]: удивляться;
paltry - [adjective]: пустяковый, ничтожный;
convict - [verb]: осуждать;
shape - [verb]: формировать, придавать форму;
suspect - [verb]: подозревать;
dismay - [noun]: испуг, тревога;
exonerate - [verb]: реабилитировать;
yearn - [verb]: тосковать, жаждать, стремиться;
die_out - [verb]: вымирать;
flip_through - [verb]: пролистывать;
biased - [adjective]: пристрастный;
excitement - [noun]: волнение, возбуждение;
blunder - [noun]: просчет, промах;
seemingly - [adverb]: по видимому, судя по виду;
far_fetched - [adjective]: надуманный, несущественный;
enormous - [adjective]: огромный;
exceedingly - [adverb]: чрезвычайно;
insight - [noun]: понимание, проницательность;
fund - [verb]: финансировать;
persist - [verb]: упорствовать;
confident - [adjective]: уверенный;
fed_up - [verb]: надоело;
delightful - [adjective]: восхитительный;
look_forward - [verb]: ждать с нетерпением;
gorgeous - [adjective]: великолпный, прекрасный;
hush - [noun]: тишина;
dread - [noun]: страх;
turns_out - [verb]: оказаться;
inevitable - [adjective]: неизбежный;
as_though - [adverb]: как будто;
frankly - [adverb]: откровенно;
odds - [noun]: шансы;
curious - [noun]: любопытство;
inclined - [adjective]: наклонный, расположенный;
entrail - [verb]: влечь за собой;
likely - [adverb]: верооятно;
certain - [adjective]: определенный, некоторный;
couple - [verb]: соединять, связывать;
predatory - [adjective]: хищный;
trial - [noun]: испытание; [adjective]: испытательный;
tribulation - [noun]: бедство, несчастье;
effort - [noun]: усилие, попытка;
entirely - [adverb]: полностью, целиком;
dilate - [verb]: распространяться;
engage - [verb]: заниматься, привлекать;
joy - [noun]: радость; [verb]: радоваться;